000000000000000000000000000000
000000000000000000000000000000
000000000000000000000000000000
000000000000000000000000000000
000000000000000000000000000000
000000000000000000000000000000
000000000000000000000000000000
000000000000000000000000000000
000000000000000000000000000000
000000000000001111100000000000
000000000000000000000000000000
000000000000000000000000000000
000001111000000000000000000000
111112222111111111111111111111
222222222222222222222222222222
222222222222222222222222222222
222222222222222222222222222222
222222222222222222222222222222
222222222222222222222222222222
222222222222222222222222222222
